##########
#........####
# $$$$$$$#  #
#.$......#  #
# $$$$$$ #  #
#......$+#  #
#$$$$$$$ #  #
#        ####
##########