##############
###          #
#   $ $  $ $ #
# $####  ### #
#  #  #  $   ##
####  #  #    ###
#### $# ### $   #
#  #      $ # $ #
#     #######$###
# $ #####.. # ##
###    .#.     #
##  ##  ##  #  #
##   .  .##   ##
##  ##..+### ##
#####...## ###
#########