######
#    ########
# #      #  #
# ##  $  $  #
# ###$ $ ## #
# ### $##.. ##
# ##   #.@.  #
# #  ###..$  #
#    # #  #  #
##############