###########
####     #
### $ #  #
##  # #$ #
#  $  $  #
#   #### ##
#####  #  #
####      #
####  #####
####   ##
####...+#
#########